                                                                                
                                                                                
                                                                                
                                                                                
                                                                                
                                                                                
                                                                                
                                                                                
                                                                                
                                                                                
          ###############      #######################################          
          #             #      #                                     #          
          #             #      #                                     #          
          #             #      #                                     #          
          #             #      #                                     #          
          #             #      #                                     #          
          #     #########      #################################     #          
          #     #       #                                      #     #          
          #     #       #                                      #     #          
          #     #       #                                      #     #          
          #     #       #                                      #     #          
          #     #       #                                      #     #          
          #     #     ####################################     #     #          
          #     #                   #                    #     #     #          
          #     #                   #                    #     #     #          
          #     #                   #                    #     #     #          
          #     #                   #                    #     #     #          
          #     #                   #                    #     #     #          
          #     #           #########      #########     #     #     #          
          #     #     #     #       #              #     #     #     #          
          #     #     #     #       #              #     #     #     #          
          #     #     #     #       #              #     #     #     #          
          #     #     #     #       #              #     #     #     #          
          #     #     #     #    ##############    #     #     #     #          
          #     #     #                       #    #     #     #     #          
          #           #                       #    #     #     #     #          
          #           #                       #    #     #     #     #          
          #           #                       #    #     #     #     #          
          #           #                       #    #     #     #     #          
          #           #                       #    #     #     #     #          
          #           #     ######            #    #     #     #     #          
          #     #     #     #                 #    #     #     #     #          
          #     #     #     #                 #    #     #     #     #          
          #     #     #     #                 #    #     #     #     #          
          #     #############                 #    #     #     #     #          
          #     #           #                 #    #     #     #     #          
          #     #           #    ##############    #     #     #     #          
          #     #           #                      #     #     #     #          
          #     #           #                      #     #     #     #          
          #     #           #                      #     #     #     #          
          #     #           #                      #     #     #     #          
          #     #     #     ########################     #     #     #          
          #     #     #                                  #     #     #          
          #     #     #                                  #     #     #          
          #     #     #                                  #     #     #          
          #     #     #                                  #     #     #          
          #     #     #                                  #     #     #          
          #     #     ####################################     #     #          
          #     #                                              #     #          
          #     #                                              #     #          
          #     #                                              #     #          
          #     #                                              #     #          
          #     #                                              #     #          
          #     ################################################     #          
          #                                                          #          
          #                                                          #          
          #                                                          #          
          #                                                          #          
          #                                                          #          
          #############################################      #########          
                                                                                
                                                                                
                                                                                
                                                                                
                                                                                
                                                                                
                                                                                
                                                                                
                                                                                
                                                                                
